Name	VCF_exists
Bos_taurus	True
Bison_bison_bison	False
Bubalus_bubalis	False
Capra_hircus	True
Ovis_aries	True
Pantholops_hodgsonii	False
Homo_sapiens	True
Pan_troglodytes	False
Chlorocebus_sabaeus	True
Macaca_mulatta	False
Mus_musculus	True
Rattus_norvegicus	False
Ornithorhynchus	False
Sarcophilus	False
Monodelphis	False
Notamacropus	False
Phascolarctos	False
Equus	True
Ceratotherium	False
